WWWWWWWWWWWWWWWWWWWWWWWWWWWWWWWWWWWWWWWWWWWWWWWWWWWWWWWWWWWWWWWWWWWWWWWWWWWWW
WWWWWWWWWWWWWWWWWWWWWWWWWWWWWWWWWWWWWWWWWWWWWWWWWWWWWWWWWWWWWWWWWWWWWWWWWWWWW
WWW                     WWWW                                               WW
WW                       WW                                                WW
WW    P                  WW                                                WW
WW                       WW                                                WW
WW           C      S    WW                                    S           WW
WW                       WW                                                WW
WW           W           WW                                                WW
DD          WWW          DD                                                WW
DD         WWWWW         DD                                                WW
DD          WWW          DD                                                WW
WW           W           WW                                                WW
WW                       WW                                                WW
WW                       WW                                    S           WW
WW           S           WW                                    S           WW
WW                       WW                                                WW
WW                       WW                                                WW
WWW                     WWWW                                               WW
WWWWWWWWWWWWLDDWWWWWWWWWW  WWWWWWWWWWWWWWWWWWWWWWWWWWWWWWWWWWWWWWWWWWWWWWWWWW
WWWWWWWWWWWWDDDWWWWWWWWWW  WWWWWWWWWWWWWWWWWWWWWWWWWWWWWWWWWWWWWWWWWWWWWWWWWW
WWW                     WWWW                                                 
WW                       WW                                                  
WW                       WW                                                  
WW                       WW                                                  
WW           C      S    WW                                                  
WW                       WW                                                  
WW           W           WW                                                  
DD          WWW          LD                                                  
DD         WWWWW         DD                                                  
DD          WWW          DD                                                  
WW           W           WW                                                  
WW                       WW                                                  
WW                       WW                                                  
WW           S           WW                                                  
WW                       WW                                                  
WW                       WW                                                  
WWW                     WWW                                                  
WWWWWWWWWWWWLDDWWWWWWWWWWWW                                                  
WWWWWWWWWWWWDDDWWWWWWWWWWWW                                                  