WWWWWWWWWWWWLDDWWWWWWWWWWWW
WWWWWWWWWWWWDDDWWWWWWWWWWWW
WWW                     WWW
WW                       WW
WW    P                  WW
WW                       WW
WW           C      S    WW
WW                       WW
WW           W           WW
DD          WWW          LD
DD         WWWWW         DD
DD          WWW          DD
WW           W           WW
WW                       WW
WW                       WW
WW           S           WW
WW                       WW
WW                       WW
WWW                     WWW
WWWWWWWWWWWWLDDWWWWWWWWWWWW
WWWWWWWWWWWWDDDWWWWWWWWWWWW