WWWWWWWWWWWWDDDWWWWWWWWWWWW
WWWWWWWWWWWWDDDWWWWWWWWWWWW
WWW                     WWW
WW                       WW
WW    P                  WW
WW                       WW
WW                  S    WW
WW                       WW
WW           W           WW
            WWW          DD
           WWWWW         DD
            WWW          DD
WW           W           WW
WW                       WW
WW                       WW
WW           S           WW
WW                       WW
WW                       WW
WWW                      WW
WWWWWWWWWWWW   WWWWWWWWWWWW
WWWWWWWWWWWW   WWWWWWWWWWWW